#############################################################################################################
#############################################################################################################
### E #                       #                   #                                               #       ###
###   #   ################    #   #########   #   #########   #################################   #   #   ###
###   #       #   #           #   #           #               #       #                   #   #   #   #   ###
###   #####   #   #   #############   #########################   #####   #########   #   #   #   #   #   ###
###           #   #               #   #           #       #               #           #       #   #   #   ###
###############   #############   #   #   #####   #   #   #####   #########   #############   #   #####   ###
###               #               #           #       #       #       #       #       #       #       #   ###
###   #############   #####################################   #########   #####   #####   #########   #   ###
###                   #       #               #               #           #       #       #           #   ###
###   #################   #   #   #   #####   #   #############   #########   #####   #####   #########   ###
###               #       #   #   #   #       #   #       #       #           #           #   #       #   ###
###############   #####   #   #   #   #   #####   #   #####   #   #########   #   #########   #   #   #   ###
###   #       #           #   #   #   #      S    #   #       #   #       #       #   #       #   #       ###
###   #   #   #############   #####   #############   #   #####   #   #   #   #####   #   #####   #####   ###
###       #               #       #   #                   #   #       #   #           #   #       #   #   ###
###   #############   #########   #   #   #################   #########   #########   #   #   #####   #   ###
###   #           #   #       #   #   #                   #       #       #       #   #   #       #   #   ###
###   #   #####   #   #   #   #   #   #################   #####   #   #####   #   #####   #####   #   #   ###
###       #       #       #           #                           #           #                   #       ###
#############################################################################################################
#############################################################################################################